11111111111111111111111
1E0~0000000000000000001
10100101001000000010101
10100101001000001010101
1010010100100000C010101
10100101001000001010101
11111111111111111111111     
