111111111111111111111111111
111X0C00000000000XXXXX00001
100001001P111X00000CC000X01
10101010C1100C0000XX001XX01
1C1X10X00000XX01110000000C1
1010010001XXXX00100000XCC01
1E100C0101C0000C0000000XC01
111111111111111111111111111